64 26

................................................................
................................................................
................................................................
................................................................
................................................................
................................................................
................................................................
................................................................
................................................................
...............................................................
...............................................................
................................................................
................................................................
................................................................
................................................................
................................................................
................................................................
....####........................................................
...............................#####............................
..............................#######...........................
........###.....#####........#########..........................
.......#####................###########.........................
......#######..............#############........................
.###############################################################
................................................................
